############################
#............##............#
#.####.#####.##.#####.####.#
# ####.#####.##.#####.#### #
#..........................#
#.####.##.########.##.####.#
#......##....##....##......#
######.##### ## #####.######
     #.##### ## #####.#     
     #.##    B     ##.#     
     #.## ###  ### ##.#     
######.## #      # ##.######
      .   #I P  C#   .      
######.## #      # ##.######
     #.## ######## ##.#     
     #.##          ##.#       
######.## ######## ##.######
#............##............#
#.####.#####.##.#####.####.#
#.####.#####.##.#####.####.#
#...##........A.......##...#
###.##.##.########.##.##.###
###.##.##.########.##.##.###
#......##....##....##......#
#.##########.##.##########.#
#..........................#
############################


/ "." pellet 
/ " " open space 
/ "#" wall 
/ "B" blinky
/ "I" inky
/ "P" pinky
/ "C" clyde